Add a bit of text below your name. Remember to pull for new updates before you commit/push.




*** Cristhian Guillermo	Arevalo Leon


*** Recve Ezgi	Atmaca


*** Marina	Barroso Avelino Aranha


*** Yumin	Cho
I need three cups of coffee


*** Banas Ajaykumar	Dalal


*** Tasanee	Dawson
I'm so sleepy. zzZzzZ

*** Don Davis


*** Anmol	Dua


*** Hunachew	Engeda


*** Daniel	Flocco


*** Najwa	Galvao Maia


*** Katrina	Garcia    :) 


*** Christian	Gonzales


*** Irina	Gorina 
Some content here


*** Kanami	Hidaka
Hello INM320

*** Didarul	Islam
Hellooooooooooooooooooooooooooooooooooooooo!

*** Fadima	Keita


*** Kyu Young	Kim


*** Minling	Liang


*** Qing	Lu


*** Amanda	Lutz
What's brown and sticky? A stick.
hahahaha


*** Sabitha	Mahesh
Hello everyone!


*** April	Malwatta


*** Pallavi	Pallavi


*** Laura	Pomeroy


*** Pragya	Prakash


*** Liz Fiorella	Remicio Tinoco


*** Melina	Shojaei


*** Jaskaran	Sondhi


*** Jairo	Torres Lizarazo


*** Md Fahim	Wali


